Quadrat_ID,Trail ,Dist_Arroyo,Under_7,Over_7,Total
1,Buho,Far,38,18,56
2,Buho,Near,22,11,33
3,Buho ,Far,23,14,37
4,Chachalaca,Far,19,12,31
5,Chachalaca,Near,10,8,18
6,Chachalaca,Near,9,9,18
7,Buho,Near,21,12,33
8,Chachalaca,Far,11,11,22
9,Sur,Far,15,10,25
10,Sur,Far,13,13,26
11,Sur,Near,10,12,22
12,Sur,Near,32,12,44